af=アフガニスタン
al=アルバニア
dz=アルジェリア
as=米領サモア
ad=アンドラ
ao=アンゴラ
ai=アンギラ島
aq=南極大陸
ag=アンティグア・バーブーダ
ar=アルゼンチン
am=アルメニア
aw=アルバ島
au=オーストラリア
at=オーストリア
az=アゼルバイジャン
bs=バハマ諸島
bh=バーレーン
bd=バングラデシュ
bb=バルバドス
by=ベラルーシ
be=ベルギー
bz=ベリーズ
bj=ベナン
bm=バミューダ
bt=ブータン
bo=ボリビア
ba=ボスニア・ヘルツェゴビナ
bw=ボツワナ
bv=ブーベ島
br=ブラジル
io=英領インド洋植民地
bn=ブルネイ・ダルサラーム
bg=ブルガリア
bf=ブルキナファソ
bi=ブルンジ
kh=カンボジア
cm=カメルーン連合共和国
ca=カナダ
cv=カボベルデ
ky=ケイマン諸島
cf=中央アフリカ共和国
td=チャド
cl=チリ
cn=中国
cx=クリスマス島
cc=ココス (キーリング) 諸島
co=コロンビア
km=コモロ諸島
cg=コンゴ
ck=クック諸島
cr=コスタリカ
ci=コートジボアール
hr=クロアチア
cu=キューバ
cy=キプロス
cz=チェコ共和国
dk=デンマーク
dj=ジブチ
dm=ドミニカ
do=ドミニカ共和国
tp=東チモール
ec=エクアドル
eg=エジプト
sv=エルサルバドル
gq=赤道ギニア
er=エリトリア
ee=エストニア
et=エチオピア
fk=フォークランド諸島 (マルビナス諸島) 
fo=フェロー諸島
fj=フィジー
fi=フィンランド
fr=フランス
fx=フランス (本国) 
gf=仏領ギアナ
pf=仏領ポリネシア
tf=仏領極南諸島
ga=ガボン
gm=ガンビア
ge=グルジア
de=ドイツ
gh=ガーナ
gi=ジブラルタル
gr=ギリシャ
gl=グリーンランド
gd=グレナダ
gp=グアドループ島
gu=グアム島
gt=グアテマラ
gn=ギニア
gw=ギニア・ビサウ
gy=ガイアナ
ht=ハイチ
hm=ハード・アンド・マクドナルド・アイランズ
hn=ホンジュラス
hk=香港
hu=ハンガリー
is=アイスランド
in=インド
id=インドネシア
ir=イラン・イスラム共和国
iq=イラク
ie=アイルランド
il=イスラエル
it=イタリア
jm=ジャマイカ
jp=日本
jo=ヨルダン
kz=カザフスタン
ke=ケニア
ki=キリバス
kp=朝鮮民主主義人民共和国
kr=韓国
kw=クウェート
kg=キルギスタン
la=ラオス
lv=ラトビア
lb=レバノン
ls=レソト
lr=リベリア
ly=リビア・アラブ国
li=リヒテンシュタイン
lt=リトアニア
lu=ルクセンブルグ
mo=マカオ
mk=マケドニア
mg=マダガスカル
mw=マラウィ
my=マレーシア
mv=モルジブ
ml=マリ
mt=マルタ
mh=マーシャル諸島
mq=マルチニーク島
mr=モーリタニア
mu=モーリシャス
yt=マヨット島
mx=メキシコ
fm=ミクロネシア
md=モルドバ共和国
mc=モナコ
mn=モンゴル
me=モンテネグロ
ms=モントセラト島
ma=モロッコ
mz=モザンビーク
mm=ミャンマー
na=ナミビア
nr=ナウル
np=ネパール
nl=オランダ
an=オランダ領アンティル諸島
nc=ニューカレドニア
nz=ニュージーランド
ni=ニカラグア
ne=ニジェール
ng=ナイジェリア
nu=ニウエ島
nf=ノーフォーク島
mp=北マリアナ諸島
no=ノルウェー
om=オマーン
pk=パキスタン
pw=パラオ
pa=パナマ
pg=パプアニューギニア
py=パラグアイ
pe=ペルー
ph=フィリピン
pn=ピトケアン島
pl=ポーランド
pt=ポルトガル
pr=プエルトリコ
qa=カタール
re=レユニオン島
ro=ルーマニア
ru=ロシア語
rw=ルワンダ
sh=セントヘレナ
kn=セントクリストファー・ネイビス
lc=セントルシア
pm=サンピエール・エ・ミクロン島
vc=セントビンセントおよびグレナディーンズ諸島
ws=西サモア
sm=サンマリノ
st=サントーメ・プリンシペ
sa=サウジアラビア
sn=セネガル
sp=セルビア
sc=セーシェル諸島
sl=シエラレオネ
sg=シンガポール
sk=スロバキア
si=スロベニア
sb=ソロモン諸島
so=ソマリア
za=南アフリカ
gs=南ジョージア島・南サンドイッチ諸島
es=スペイン
lk=スリランカ
sd=スーダン
sr=スリナム
sj=スバールバル諸島・ヤンマイエン島
sz=スワジランド
se=スウェーデン
ch=スイス
sy=シリア・アラブ共和国
tw=台湾
tj=タジキスタン
tz=タンザニア連合共和国
th=タイ
tg=トーゴ
tk=トケラウ諸島
to=トンガ
tt=トリニダードトバゴ
tn=チュニジア
tr=トルコ
tm=トルクメニスタン
tc=タークス諸島およびカイコス諸島
tv=ツバル
ug=ウガンダ
ua=ウクライナ
ae=アラブ首長国連邦
uk=英国
us=米国
um=アメリカ合衆国統治領諸島
uy=ウルグアイ
uz=ウズベキスタン
vu=バヌアツ
va=バチカン市国
ve=ベネズエラ
vn=ベトナム
vg=バージン諸島 (英領) 
vi=バージン諸島 (米領) 
wf=ウォリス・フトーナ諸島
eh=西サハラ
ye=イエメン共和国
yu=旧ユーゴスラビア領
zr=ザイール
zm=ザンビア
zw=ジンバブエ
com=米国営利組織
arpa=旧arpanet/逆引き用名前空間
edu=北米4年制大学
gov=米国政府機関
int=国際機関
mil=米軍
nato=北大西洋条約機構関係機関
net=ネットワーク組織
org=非営利団体
aero=航空
biz=ビジネス
coop=協同組合
info=一般
museum=博物館
name=個人
pro=専門職
